Mi gran noche - Raphael
A quién le importa - Alaska Y Dinarama
Madre Tierra (Oye) - Chayanne
Dolores Se Llamaba Lola - Remastered - Los Suaves
La Cintura (feat. Flo Rida & Tini) - Remix - Alvaro Soler, Flo Rida, TINI
Sofia - Alvaro Soler
Lo Malo - Aitana, Ana Guerra
Déjala Que Baile (with Alejandro Sanz & Arkano) - Melendi, Alejandro Sanz, Arkano
El Anillo - Jennifer Lopez
Déjala Que Vuelva (feat. Manuel Turizo) - Piso 21, Manuel Turizo
1, 2, 3 (feat. Jason Derulo & De La Ghetto) - Sofía Reyes, Jason Derulo, De La Ghetto
Calypso - Luis Fonsi, Stefflon Don
Ni La Hora - Ana Guerra, Juan Magán
Duro y Suave - Leslie Grace, Noriel
A Partir De Hoy - David Bisbal, Sebastian Yatra
Fuego - Eleni Foureira
TELÉFONO - Aitana
Vaina Loca - Ozuna, Manuel Turizo
Bella - Remix - Wolfine, Maluma
Ya No Quiero Ná - Lola Indigo
La llave (feat. Piso 21) - Pablo Alborán, Piso 21
Lo Mismo - GIMS, Alvaro Soler
La casa por el tejado - Fito y Fitipaldis
Por la boca vive el pez - Fito y Fitipaldis
Whisky barato - Fito y Fitipaldis
Stand By Me - Florence + The Machine
Una calle de París - Duncan Dhu
Carolina - En directo 2000 - M-Clan
Déjame - Los Secretos
Como un burro amarrado en la puerta del baile - 2008 Remastered Version - El Último De La Fila
Cien gaviotas - Duncan Dhu
Salir - Extremoduro
Insurreccion (En Directo) - El Último De La Fila
Bienvenidos (En Directo) - Miguel Ríos
20 de abril - En directo 1997 - Celtas Cortos
Perdonarme (feat. Taburete) - Café Quijano, Taburete
1+1 Son 7 - Fran Perea
Princesas - Pereza
Soy Yo - Marta Sánchez
La Bomba - King Africa
Son de Amores - Andy & Lucas
La Tortura (feat. Alejandro Sanz) - Shakira, Alejandro Sanz
Nada Fue Un Error - Coti
Cuando zarpa el amor - Camela
Colgando en tus manos (con Marta Sánchez) - Carlos Baute, Marta Sánchez
La Camisa Negra - Juanes
Ave María - David Bisbal
Solamente tú - Pablo Alborán
Tenia Tanto Que Darte - Nena Daconte
Antes Muerta Que Sencilla - María Isabel
Y Yo Sigo Aqui - Paulina Rubio
Torero - Chayanne
Besos - El Canto Del Loco
Que La Detengan - David Civera
Vem Dancar Kuduro - Don Omar, Lucenzo
La Gozadera (feat. Marc Anthony) - Gente De Zona, Marc Anthony
Reggaetón Lento (Bailemos) - CNCO
Cómo Te Atreves - Morat
Felices los 4 - Maluma
La Bicicleta - Carlos Vives, Shakira
Bailando por Ahi - Juan Magán
SUBEME LA RADIO (feat. Descemer Bueno & Zion & Lennox) - Enrique Iglesias, Descemer Bueno, Zion & Lennox
Despacito - Luis Fonsi, Daddy Yankee
Bailando - Spanish Version - Enrique Iglesias, Descemer Bueno, Gente De Zona
Chantaje (feat. Maluma) - Shakira, Maluma
Terriblemente Cruel - Leiva
DUELE EL CORAZON (feat. Wisin) - Enrique Iglesias, Wisin
Lady Madrid - Pereza
Dramas y comedias - Fangoria
El roce de tu cuerpo - Platero Y Tu
Me Olvide De Vivir - Julio Iglesias
Soy un Truhán, Soy un Señor - Julio Iglesias
Me Va, Me Va - Julio Iglesias
Zapatillas - El Canto Del Loco
Hasta Que Se Seque el Malecón (feat. Farruko) - Remix - Jacob Forever, Farruko
Rayos de Sol - José de Rico, Henry Mendez
Te Pintaron Pajaritos - Yandar & Yostin, Andy Rivera
Suavemente - Elvis Crespo
Destination Calabria - Radio Edit - Alex Gaudino
Vivir Mi Vida - Marc Anthony
El Taxi (feat. Sensato & Osmani Garcia) - Pitbull, Sensato, Osmani Garcia "La Voz"
Gasolina - Daddy Yankee
I Know You Want Me (Calle Ocho) - Pitbull
El Tiburón (The Shark) - Henry Mendez
I Gotta Feeling - Black Eyed Peas
Ai Se Eu Te Pego - Ao Vivo - Michel Teló
Blurred Lines - Robin Thicke, T.I., Pharrell Williams
Wake Me Up - Avicii
El Perdón (with Enrique Iglesias) - Nicky Jam, Enrique Iglesias
Saturday Night - Radio Mix - Whigfield
We No Speak Americano (Edit) - Yolanda Be Cool, DCup
The Ketchup Song (Aserejé) - Spanish Version - Las Ketchup
La Bilirrubina - En Vivo Estadio Olímpico De República Dominicana/2012 - Juan Luis Guerra 4.40
Ain't Your Mama - Jennifer Lopez
Picky - Joey Montana
Party Rock Anthem - LMFAO, Lauren Bennett, GoonRock
Call Me Maybe - Carly Rae Jepsen
Levantando las Manos - El Simbolo
Aquí No Hay Playa - The Refrescos
CAN'T STOP THE FEELING! (from DreamWorks Animation's "TROLLS") - Justin Timberlake
