Mayonesa - Chocolate
Sueño su Boca - Raul
Ni Una Sola Palabra - Paulina Rubio
Arrasando - Thalia
Vive la Vida - Remix - Gusanito
Ven, Ven, Ven - Ven
El De Los Ojos Negros - Sparx
Que El Ritmo No Pare - Patricia Manterola
Dime - Beth
Yo Quiero Bailar - Sonia Y Selena
Que La Detengan - David Civera
Ave María - David Bisbal
Torero - Chayanne
Levantando las Manos - El Simbolo
Y Yo Sigo Aqui - Paulina Rubio
Te Quiero Más - Fórmula Abierta
Sarandonga - Lolita
Cuando zarpa el amor - Camela
Solo Se Vive una Vez - Azucar Moreno
El Baile del Gorila - Melody
Dragostea din tei - O-Zone
Dos Hombres Y Un Destino - Bustamante, Alex
Europe's Living A Celebration (Version Cibeles) - Rosa López
Sambame - Upa Dance
Dile Que La Quiero - David Civera
Antes Muerta Que Sencilla - María Isabel
Por la Raja de Tu Falda - Estopa
Corazon Latino - David Bisbal
Obsesion - Aventura, Judy Santos
María - Ricky Martin
La Bomba - King Africa
Loca - Malena Gracia
Soy Yo - Marta Sánchez
Sobreviviré - Monica Naranjo
La Madre de Jose - El Canto Del Loco
Devuelveme La Vida - Bustamante
Me Pongo Colorada - Papa Levante
Buleria - David Bisbal
A toda mecha - S.J.K.
Suavemente - Elvis Crespo
Gasolina - Daddy Yankee
Vas A Volverme Loca - Natalia
La Cancion del Velero - Bandabailando
Oye El Boom - David Bisbal
Abre Tu Mente - Merche
Atrevete - Chenoa
Livin' la Vida Loca - Ricky Martin
Carolina - En directo 2000 - M-Clan
Nunca Te Decides (Que Si, Que No) - El Simbolo
Caminando por la vida - Melendi
Baila Morena - New Spanish Version - Zucchero, Maná
Follow the Leader "Sigue al lider" - Sol Habana
A Dios Le Pido - Juanes
Corazón Salvaje - Marcela Morelo
Son de Amores - Andy & Lucas
Asereje - Rod S Band
Micromania (Original Mix) - Tata Golosa
Ciega, Sordomuda - Shakira
Summerlove - David Tavaré
Tanto la Queria - Andy & Lucas
Noche De Sexo - Wisin & Yandel, Romeo Santos
Oye - Gloria Estefan
Azul - Kike Santander, Gustavo Santander, Cristian Castro
Papi Chulo... Te Traigo El Mmmm - Radio Version - Lorna
Cachete, Pechito y Ombligo - Cumbia Latin Band
Para Llenarme De Ti - Ramon
Color Esperanza - Diego Torres
Mentirosa - Rafaga
A-Ba-Ni-Bi - El Chaval De La Peca
La Ventanita - Sergio Vargas
El Baile De La Ola - 3+2
Olvídame y Pega la Vuelta - Pimpinela
Hips Don't Lie (feat. Wyclef Jean) - Shakira, Wyclef Jean
Duele El Amor - Aleks Syntek, Ana Torroja
Amor Prohibido - Selena
Una Noche Más - Jennifer Lopez
Toma Vitamina - La Fiesta
No Soy Un Superman - Bustamante
Vi sitter i Ventrilo och Spelar DotA - Basshunter
Blue (Da Ba Dee) - Gabry Ponte Video Edit - Eiffel 65, Gabry Ponte
Lloraré Las Penas - David Bisbal
Salome - Club Mix-Radio Edit - Chayanne, Pedro Del Moral, David Ferrero
Saturday Night - Radio Mix - Whigfield
Dale Don Dale - Don Omar
Let's Get Loud - Jennifer Lopez
Lo Que Pasó, Pasó - Daddy Yankee
Mi Música Es Tu Voz - En Directo 2002 / Remastered 2016 - Academia Operacion Triunfo
La Tortura (feat. Alejandro Sanz) - Shakira, Alejandro Sanz
No Rompas Mi Corazón - Trip Band
Esto Es Pa Ti - Grupo Santa Fe
Escondidos - Remastered 2016 - David Bisbal, Chenoa
Heaven - DJ Sammy, D/O
Superstar - Jamelia
I Will Love Again - Lara Fabian
Viva la noche - Various Artists
Cuando Tú Vas - Chenoa
Baila Casanova - Paulina Rubio
Como Ronea - Las Chuches
¡No Me Toques Las Palmas Que Me Conozco! - María Isabel
Navegando En Internet - Peque-Kids
