Alocao (With Bad Gyal) - Omar Montes, Bad Gyal
RITMO (Bad Boys For Life) - Black Eyed Peas, J Balvin
Indeciso - Reik, J Balvin, Lalo Ebratt
Te Quemaste - Manuel Turizo, Anuel AA
Si Te Vas - Sech, Ozuna
Goteo - Duki
La Rubia - Remix 2 - La Nueva Escuela, Omar Montes
Easy - Jhayco
Qué Pena - Maluma, J Balvin
Conmigo - Moncho Chavea, Omar Montes
Hookah - Bad Gyal
Fiebre (Prod. King DouDou) - Bad Gyal
Santa María (Feat. Busy Signal) - Bad Gyal, Busy Signal
QUE PRETENDES - J Balvin, Bad Bunny
Chambea - Bad Bunny
Desde el Corazón - Bad Bunny
DOLLAR - Becky G, Myke Towers
Soy Un Don - Juan Magán, Mozart La Para, DCS
Se iluminaba - Fred De Palma, Ana Mena
La Difícil - Bad Bunny
La Santa - Bad Bunny, Daddy Yankee
Yo Perreo Sola - Bad Bunny
Bichiyal - Bad Bunny, Yaviah
Que Malo - Bad Bunny, Ñengo Flow
Ignorantes - Bad Bunny, Sech
A Tu Merced - Bad Bunny
Safaera - Bad Bunny, Jowell & Randy, Ñengo Flow
Está Cabrón Ser Yo - Bad Bunny, Anuel AA
Amarillo - J Balvin
Azul - J Balvin
Rojo - J Balvin
Morado - J Balvin
Negro - J Balvin
Gris - J Balvin
Blanco - J Balvin
Baila Conmigo (feat. Kelly Ruiz) - Dayvi, Victor Cardenas, Kelly Ruíz
Rueda - Remix - Chimbala, Juan Magán, Omar Montes, PV Aparataje
Bum Bum Tam Tam - MC Fioti, Future, J Balvin, Stefflon Don, Juan Magán
Se Vuelve Loca - Juan Magán
Ella No Sigue Modas - Juan Magán, Don Omar
Chica Latina - Juan Magán, Salgado
Tu Eres Un Bom Bom - Remix - Kafu Banton, Bad Gyal
Zorra - Bad Gyal
La Rompe Corazones - Daddy Yankee, Ozuna
El Efecto - Remix - Rauw Alejandro, Chencho Corleone, KEVVO, Bryant Myers, Lyanno, Dalex
CANCIÓN CON YANDEL - Yandel, Bad Bunny
PA' ROMPERLA - Bad Bunny, Don Omar
Muévelo - Nicky Jam, Daddy Yankee
Entre la Playa Ella y Yo - Big Yamo, Vato 18k
Mayor Que Yo 3 - Luny Tunes, Daddy Yankee, Don Omar, Wisin & Yandel
La Disco Resplandece - La Mafia del Amor x El Combo Perfecto, El Combo Perfecto
Noche De Sexo - Wisin & Yandel, Romeo Santos
Cuando Te Besé - Becky G, Paulo Londra
Me Rehúso - Danny Ocean
China - Anuel AA, Daddy Yankee, KAROL G, J Balvin, Ozuna
Otro Trago - Remix - Sech, Ozuna, Anuel AA, Darell, Nicky Jam
Que Calor - Major Lazer, J Balvin, El Alfa
Apriétala - Rvfv, Pablo Mas
Betoven - WildBoy Cooba
Tusa - KAROL G, Nicki Minaj
105 F Remix - KEVVO, Farruko, Chencho Corleone, Arcangel, Darell, Ñengo Flow, Brytiago, Myke Towers
Marianela - Lirico En La Casa
Prendio (Remix) - Rvfv, Omar Montes, Daviles de Novelda
Pegamos Tela - Lérica, Omar Montes, Abraham Mateo
Cuando zarpa el amor (feat. Juan Magán) - Camela, Juan Magán
Medusa - Jhayco, Anuel AA, J Balvin
4K - El Alfa, Darell, Noriel
Losing It - FISHER
La Madre de Jose - El Canto Del Loco
Besos - El Canto Del Loco
Zapatillas - El Canto Del Loco
Devuélveme a mi chica - Hombres G
Voy a pasármelo bien - Hombres G
Como Camarón - Estopa
Corazón partío - Alejandro Sanz
Kisiera Yo Saber - Melendi
Caminando por la vida - Melendi
Rayos de Sol - José de Rico, Henry Mendez
Noche de Estrellas - José de Rico, Henry Mendez, Jay Santos
Angelito Sin Alas (feat. Juan Magán) - Remix - DCS, Juan Magán
Te Pintaron Pajaritos - Yandar & Yostin, Andy Rivera
La conocí bailando (feat. K-Narias) - Radio Edit - Dr. Bellido, K-Narias
Yo Te Esperaré - Cali Y El Dandee
Limbo - Daddy Yankee
Adrenalina (feat. Jennifer Lopez & Ricky Martin) - Wisin, Jennifer Lopez, Ricky Martin
Atrévete-Te-Te - Calle 13
6 AM - J Balvin, Farruko
Fanática Sensual - Plan B
Amaneci Contento - Secreto "El Famoso Biberon"
Él No Te Da - Dasoul
Hasta Que Se Seque el Malecón (feat. Farruko) - Remix - Jacob Forever, Farruko
Safari - J Balvin, Pharrell Williams, BIA, Sky Rompiendo
Mi Vecinita - Plan B
4 besos - Lola Indigo, Rauw Alejandro, Lalo Ebratt
La Jeepeta - Remix - Nio Garcia, Anuel AA, Myke Towers, Brray, Juanka
Tak Tiki Tak - Harry Nach
Flamenkito - Lérica, Belinda
Con Altura - ROSALÍA, J Balvin, El Guincho
Llorando en la Limo (feat. Alizzz) - C. Tangana, Alizzz
Mentirosa - Rafaga
