Lo Siento Mama - Reality, Keenoo
Dos Días al Mes - Hens, Delgao
Pikete Italiano - KvndySwing
Bad Day - Justus Bennetts
No Me Renta - EZVIT 810
No Me digas Nada - Quevedo
Dubi Dubi Du - Dino
ANGELS & DEMONS - jxdn
2002 - Anne-Marie
Lucid Dreams - Juice WRLD
Robbery - Juice WRLD
Gira Que Gira - Ters
The Hurt You Gave Me - Robert Grace
MEMORIES! - 347aidan
Pasta - New Rules
Goosebumps - Remix - Travis Scott, HVME
Tal Vez - Paulo Londra
2055 - Sleepy Hallow
TOP 5 - Duki
Tú Me Vuelves Loco - Emporio, MOL, Willi.Ch, Juanmi G, Camale
What If I Told You That I Love You - Ali Gatie
Nineteen - Dylan
lead me on - sammy rash
either way - Arden Jones
Rover (feat. DTG) - S1mba, DTG
No te decides - Dudi
Miedo - Reality
Pa Siempre - Emporio, MOL
rockstar (feat. 21 Savage) - Post Malone, 21 Savage
Love Me - Lil Tecca
Talk Tough - Dustystaytrue
Mareas - Serko
Si No Es Contigo - Dominguez Flaco, Miranda
The Same Way - Don Diablo, KiFi
Nomad - Chri$tian Gate$
Made with Love - KvndySwing
Plan A - Paulo Londra
Little Lion Man - Mumford & Sons
Como Estrellas - LA YOUNG
serotonin highs (feat. Allen Haley) - Arden Jones, Allen Haley
Love Yourself - Justin Bieber
Sex Sounds - Lil Tjay
Trap Queen - Fetty Wap
Me basta con mirarte - Deco Mdz
indifferent - Arden Jones
Paulo Londra: Bzrp Music Sessions, Vol. 23 - Bizarrap, Paulo Londra
La Herida - Enol
la di da - acoustic - Arden Jones
Chanel Bag - KillBunk
Party Girl - StaySolidRocky
Shut Up and Dance - WALK THE MOON
IDGAF (with blackbear) - BoyWithUke, blackbear
F My Ex - KAVO
Perfect Strangers - Jonas Blue, JP Cooper
Our Time - Lil Tecca
Todo Hiela - Manu Cort
Cada Motivo - EZVIT 810, Lu Decker, Calero LDN
WYD Now? [Feat. Zai1k & Zakhar] - Sadie Jean, Zakhar, Zai1k
Lie - NF
Tu y Yo - Ceaxe
Sincero - 31 FAM
On & On - Cartoon, Daniel Levi
that way - Tate McRae
No Me digas Nada - Quevedo
Des del Dia 1 - 31 FAM
ILY - Rulo 901
Desconfiao - Hens, Lionware
Que bien queda tu tanga - Stormykid
Amor Amargo - JM, GiGi
La Salida - Rouss, Hens
x ti - Paula Cendejas
Mi Luz (ft. Rels B) - Rvfv, Rels B
SugarCrash! - ElyOtto
Quédate conmigo - Pole., Pilar Moxó
Mami - Rvfv, Pablo Mas
La Gent Que Estimo - Oques Grasses, Rita Payés
Veneno - Delaossa, KIDDO, J.Moods
Rover (feat. Lil Tecca) - S1mba, Lil Tecca
Perdona (Ahora Sí Que Sí) - Carolina Durante, Amaia
Like Aron Piper (feat. Bejaa) - Dudi, Bejaa
SNAP - High and Fast - Rosa Linn
heat waves - sped up + reverb - sped up + reverb tazzy, sped up songs, Tazzy
El último verano - Pole., 333.Empty
In The Stars - Benson Boone
Vértigo - Serko
Villano Antillano: Bzrp Music Sessions, Vol. 51 - Bizarrap, Villano Antillano
Amuleto - Maikel Delacalle
Como Panas - Bryant Myers
Nens Del Barri - 31 FAM
Whisky and Spice - Yeico X Toni, Yeico, Toni
Intoxicao - Hens
Volverte a Ver - Dluna
Story of My Life - One Direction
Atlantis - Extra Sped Up Version - Seafret
Summertime Sadness - Sped Up - Lana Del Rey, Speed Radio
Contigo - Ernes H
Qué Bonito Fue - Funzo & Baby Loud
Antes - Ernes H
Perdido - Ernes H
GIVENCHY - Duki
