Duki: Bzrp Music Sessions, Vol. 50 - Bizarrap, Duki
Punto G - Quevedo
La Bachata - Manuel Turizo
Hey Mor - Ozuna, Feid
Quevedo: Bzrp Music Sessions, Vol. 52 - Bizarrap, Quevedo
APA - Mora, Quevedo
Vista Al Mar - Quevedo
Mbappe - Eladio Carrion
DESPECHÁ - ROSALÍA
PUNTO 40 - Rauw Alejandro, Baby Rasta
Besos Moja2 - Wisin & Yandel, ROSALÍA
Monotonía - Shakira, Ozuna
Sin Señal - Quevedo, Ovy On The Drums
Feliz Cumpleaños Ferxxo - Feid
CALENTÓN - Mora
CAIRO - KAROL G, Ovy On The Drums
AUTOMÁTICO - Maria Becerra
MEMORIAS - Mora, Jhayco
No Me digas Nada - Quevedo
pa quererte - Rels B
Caile - Luar La L
LA INOCENTE - Mora, Feid
HOPE (with Kidd Keo) - TALE$, Kidd Keo
COMO HAS ESTAU? - Mora
LOKERA - Rauw Alejandro, Lyanno, Brray
Me Porto Bonito - Bad Bunny, Chencho Corleone
Cinderella - Cyril Kamer
Traductor - Tiago PZK, Myke Towers
LAS 12 - Ana Mena, Belinda
A Veces (feat. Feid) - Paulo Londra, Feid
LEJOS DEL CIELO - Rauw Alejandro
I'm Good (Blue) - David Guetta, Bebe Rexha
Hugo - Eladio Carrion
mariposas - sangiovanni, Aitana
Tití Me Preguntó - Bad Bunny
Diablo - Beret, Estopa
Tarot - Bad Bunny, Jhayco
Ojitos Lindos - Bad Bunny, Bomba Estéreo
En La De Ella - Jhayco, Feid, Sech
Tiago PZK: Bzrp Music Sessions, Vol. 48 - Bizarrap, Tiago PZK
Te Felicito - Shakira, Rauw Alejandro
Muchoperro - Juseph, Cruz Cafuné, Wiso Rivera
Piel de Cordero - Quevedo, La Pantera
Miss You - Oliver Tree, Robin Schulz
Luces De Neón - Myke Towers
Si Tú Te Vas (feat. Yung Beef) - Remix - Omar Montes, Khaled, Kaydy Cain, Yung Beef
DOMINGO DE BOTE - Mora
Si Te La Encuentras Por Ahí - Feid
Caras Vemos - Eladio Carrion
Si la Calle Llama - Eladio Carrion
